
// some names
assam	অসম
axom	অসম
tezpur	তেজপুৰ
luitpad 	লুইতপেড
kishori 	কিশোৰী
konwar	কোঁৱৰ


//Counties
Japan	জাপান
Australia	অষ্ট্ৰেলিয়া
Austria	অষ্টিয়া
Belgium	বেলজিয়াম
Brazil	ব্ৰাজিল
Bulgaria	বুলগেৰিয়া
Canada	কানাডা	
China	চীন
HongKong	হংকং
European	ইউৰোপিয়ান	
Union	ইউনিয়ন
France	ফ্ৰান্স
Germany	জাৰ্মানী	
India	ভাৰত
Indonesia	ইণ্ডোনেছিয়া	
Italy	ইটালী
Japan	জাপান
Mexico	মেক্সিকো
Netherlands	নেদাৰলেণ্ড	
Norway	নৰৱে
Pakistan	পাকিস্তান
Philippines	ফিলিপাইনছ
Poland	পোলেণ্ড
Portugal	পৰ্তুগাল
Russia	ৰাছিয়া
Romania	ৰুমানিয়া	
Africa	আফ্ৰিকা
Spain	স্পেইন
Sweden	ছুইডেন
Switzerland	ছুইজাৰলেণ্ড	
Taiwan	টাইৱান
Turkey	টুৰ্কি
Ukraine	ইউক্ৰেন
Africa	আফ্ৰিকা
America	আমেৰিকা
North	উত্তৰ
Asia	এছিয়া
Europe	ইউৰোপ
// places in assam
Abhayapuri	অভয়াপুৰী	
Amguri	আমগুৰি
Anand	আনন্দ
Badarpur	বদৰপুৰ	
Bamun	বামুণ
Barpeta	বৰপেটা	
Bihpuria	বিহপুৰীয়া	
Bilasipara	বিলাসীপাৰা	
Biswanath	বিশ্বনাথ	
Bohari	বহাৰী
Bokajan	বোকাজান
Bokakhat	বোকাখাত	
Bongaigaon	বঙ্
Chabua	চাবুৱা
Chandrapur	চন্দ্ৰপুৰ	
Chapar	চাপৰ
Dergaon	দেৰগাওঁ	
Dharapur	ধাৰাপুৰ	
Dhekiajuli	ঢেকীয়াজুলি	
Dhemaji	ধেমাজি
ASSAM	অসম
Dhing	ধিং
Dhubri	ধুবুৰী
Dibrugarhd	ডিব্ৰুগড়	
Digboi	ডিগবৈ
Diphu	ডিফু
Dispur	দিছপুৰ
Doboka	ডবকা
Dokmoka	ডকমকা	
Duliajan	দুলীয়াজান
Durga	দুৰ্গা
Gauripur	গৌৰীপুৰ	
Goalpara	গোৱালপাৰা	
Gohpur	গহপুৰ
Golaghat	গোলাঘাট	
Golokganj	গোলোকগঞ্জ	
Gossaigaon	গচাইগাঁও
Guwahati	গুৱাহাটী	
Hailakandi	হাইলাকান্দি	
Hamren	হামৰেণ
Hindustan	হিন্দুস্তান
Hojai	হোজাই
Howli	হাউলী
Howraghat	হাওৰাঘাট
Jagiroad	জাগীৰোড
Jonai	জোনাই
Jorhat	যোৰহাট
Kampur	কামপুৰ
Karimganj	কৰিমগঞ্জ	
Kharupatia	খাৰুপেটীয়া	
Kokrajhar	কোকৰাঝাৰ	
Lakhimpur	লক্ষীমপুৰ	
Lanka	লংকা
Lido	লিডু
Lumding	লামডিং	
Maibong	মাইবং
Makum	মাকুম
Mangaldoi	মঙ্গলদৈ	
Mankachar	মানকাছাৰ	
Margherita	মাৰ্ঘেৰিটা	
Mariani	মৰিয়ণী
Marigaon	মৰিগাঁও	
Moran	মৰাণ
Moranhat	মৰাণহাট	
Nagaon	নগাঁও
Naharkatiya	নাহৰকটীয়া	
Nalbari	নলবাৰী
Namrup	নামৰূপ
Naubaisa	নাওঁবৈচা	
Nazira	নাজিৰা
Numaligarh	নুমলীগড়	
Palasbari	পলাশবাৰী	
Pathsala	পাঠশালা
Rangapara	ৰঙাপাৰা	
Rangia	ৰঙিয়া
Salakati	চলাকাটী
Sapatgram	সপ্তগ্ৰাম	
Sarbhog	সৰ্ভোগ
Sarthebari	সৰ্থেবাৰী	
Sarupathar	সৰুপথাৰ	
Sibsagar	শিৱসাগৰ	
Silapathar	চিলাপথাৰ	
Silchar	শিলচৰ
Sonari	সোণাৰি
Sualkuchi	শুৱালকুচি	
Tangla	টংলা
Tezpur	তেজপুৰ
Tihu	টিহু
Tinsukia	তিনিচুকীয়া
Titabor	তিতাবৰ
Udalguri	ওদালগুৰি
//states in india
Uttar	উত্তৰ
Pradesh	প্ৰদেশ	
Maharashtra	মহাৰাষ্ট্ৰ	
Bihar		বিহাৰ	
West	পশ্চিম
Bengal	বংগ	
Andhra		অন্ধ্ৰ
Madhya	মধ্য
Tamil-Nadu	তামিলনাডু	
Rajasthan	ৰাজস্থান
Karnataka	কৰ্ণাটক
Gujarat		গুজৰাট
Orissa		উৰিষ্যা
Kerala		কেৰেলা
Jharkhand	ঝাৰখণ্ড
Punjab		পঞ্জাৱ	
Haryana		হাৰিয়ানা
Chhattisgarh		চট্টিছগড়
Jammu		জম্মু
Kashmir	কাশ্মীৰ
Uttarakhand	উত্তৰাখণ্ড
Himachal	হিমাচল
Tripura		ত্ৰিপুৰা
Meghalaya	মেঘালয়
Manipur	মণিপুৰ
Nagaland	নাগালেণ্ড
Goa		গোৱা
Arunachal	অৰুণাচল	
Mizoram	মিজোৰাম
Sikkim		ছিকিম
Delhi		দিল্লী	
Pondicherry	পণ্ডীচেৰী
Chandigarh	চণ্ডীগড়
Andaman	আন্দামান
Nicobar		নিকোবৰ
Islands	আইলেণ্ড
Dadra		দাদৰা	
Nagar		নগৰ
Haveli		হাভেলী
Daman		দমন
Diu		দিউ
Lakshadweep	লক্ষ্যদীপ
//cities in  india
Mumbai	মুম্বাই
Bombay	মুম্বাই
Bangalore	বাংগালোৰ
Hyderabad	হায়দৰাবাদ
Ahmedabad	আহমেদাবাদ
Chennai	চেন্নাই	
Kolkata	কলিকতা
Madras	চেন্নাই	
Calcutta	কলিকতা
Surat	চুৰাট	
Pune	পুণে
Jaipur	জয়পুৰ
Lucknow	লক্ষ্ণৌ
Nagpur	নাগপুৰ
Indore	ইন্দোৰ
Thane	থানে	
Bhopal	ভূপাল
Visakhapatnam	বিশাখাপট্টনম
Patna	পাটনা
Vadodara	বাদোদাৰা
Ghaziabad	গাজিয়াবাদ
Ludhiana	লুধিয়ানা
Agra	আগ্ৰা	
Nashik	নাছিক
Faridabad	ফৰিদাবাদ
Meerut	মীৰাট
Rajkot	ৰাজকোট	
Varanasi	বাৰণসী	
Srinagar	শ্ৰীনগৰ	
Aurangabad	ঔৰংগবাদ
Dhanbad	ধানবাদ
Amritsar	অমৃতসৰ
Allahabad	এলাহাবাদ
Ranchi	ৰাঁচী	
Howrah	হাওৰা
Coimbatore	কইম্বেটোৰ
Jabbalpur	জব্বলপুৰ
Gwalior	গোৱালিয়ৰ
Vijayawada	বিজয়াবাঢ়া
Jodhpur	যোধপুৰ
Madurai	মাদুৰাই
Raipur	ৰায়পুৰ
Kota	কোটা	
Guwahati	গুৱাহাটী
Chandigarh	চণ্ডীগড়
Solapur	চোলাপুৰ
Bareilly	বেৰেলী
Moradabad	মোৰাদাবাদ
Mysore	মহীশূৰ
Gurgaon	গুৰগাঁও
Aligarh	আলিগঁড়
Jalandhar	জলন্ধৰ
Tiruchirappalli	তিৰুচিৰাপল্লী
Bhubaneswar	ভুৱনেশ্বৰ
Salem	ছেলিম	
Thiruvananthapuram	তিৰুবান্দমপুৰম
Saharanpur	চাহাৰণপুৰ
Gorakhpur	গডকপুৰ
Bikaner	বিকানীৰ
Amravati	অমৰাৱতী
Noida	নয়দা
Jamshedpur	জামছেদপুৰ
Bhilai	ভিলাই
Warangal	ৱাৰেংগল
Cuttack	কটক	
Firozabad	ফিৰোজাবাদ
Kochi	কোচি
Dehradun	ডেৰাডুন
Durgapur	দূৰ্গাপুৰ	
Kolhapur	ক'লহাপুৰ
Ajmer	আজমীৰ
Gulbarga	গুলবাৰ্গা
Jamnagar	জামনগৰ
Ujjain	উজ্জয়েন	
Siliguri	শিলিগুৰি
Jhansi	ঝাঁঝী